{
"level": [
  "GGGGGGGGGGGGGGGGGGGGGGGGGGGGGGGGGGGGGGGGGGGGGGGGGGGGGGGGGGGG",
  "G0000000000000000000000000000000000000000000000000000000000G",
  "G0M00000000000000G000000000000000M0000000000000000000000000G",
  "G000000000000M000G00000GGGG00000000000000000GGGGGG000MGGGGGG",
  "G00000M00000000000000000000000000000M0000000000000000000000G",
  "G0000000000G00000000000000000000000000000000000000000000000G",
  "G0000000000G000000000M00000000GGG0000000000000M000000000000G",
  "GGGG0000000G000M0000000000000000G00000000000000000000M00000G",
  "G0000000000G00000000000000000000G000000GGGGG000000000000000G",
  "G0000000000G00000000000000000000G000M000000000000G00000GGGGG",
  "G000M000000GGGGGGGG000000000M000G0000000000000000G000000000G",
  "G0000000000G000000000000G000000000000000000000000G000000000G",
  "G0000000000G000000000000G00000000000000G0000000000000000000G",
  "G00M000G0000000000000000G000000000M0000G00M000M000000000G00G",
  "G000000G00000000M0000000G0000M000000000G000000000G000000G00G",
  "G000000G0000000000000000G00000000000000G000000000G000M00G00G",
  "GGG00GGG000000000000000000000000000GGGGG0000000000000000G00G",
  "G00000000000M0000GGG0000000000000000000000M0000000000000G00G",
  "G00000000000000000000000000000000000000000000000M0000000000G",
  "GGGGGGGGGGGGGGGGGGGGGGGGGGGGGGGGGGGGGGGGGGGGGGGGGGGGGGGGGGGG"

]
}